b,b,b,b,b,b,b,b,b,b,b,b,b,b,b,b
b,s,0,0,0,0,k,0,0,0,0,0,0,0,0,b
b,0,0,0,0,0,0,0,0,0,0,0,0,0,0,b
b,0,0,b,b,b,b,0,0,0,0,k,0,0,k,b
b,0,0,b,g,0,k,0,0,0,0,k,0,0,k,b
b,0,0,b,b,0,b,0,0,0,0,k,0,0,k,b
b,0,l,0,b,0,0,0,0,0,0,k,0,k,0,b
b,0,0,0,b,0,0,0,0,0,0,k,k,0,0,b
b,0,k,0,b,0,0,0,0,0,0,k,0,0,0,b
b,b,b,b,b,b,b,b,b,b,b,b,b,b,b,b