b,b,b,b,b,b,b,b,b,b,b,b,b,b,b,b
b,s,0,0,0,0,b,0,0,0,0,0,0,0,0,b
b,0,0,0,0,0,0,0,b,0,0,0,0,0,0,b
b,0,0,0,b,b,b,0,0,0,0,k,k,0,k,b
b,0,0,0,b,b,b,0,0,0,0,k,0,0,k,b
b,0,0,0,b,b,b,0,0,0,0,k,0,k,k,b
b,0,0,l,k,k,k,0,0,0,0,k,0,k,k,b
b,0,0,b,b,b,b,0,0,0,0,k,0,b,b,b
b,b,b,b,b,b,b,0,0,0,0,k,g,b,b,b
b,b,b,b,b,b,b,b,b,b,b,b,b,b,b,b