b,b,b,b,b,b,b,b,b,b,b,b,b,b,b,b
b,0,0,b,b,b,b,b,b,b,b,b,b,b,b,b
b,0,l,0,0,0,0,0,0,0,0,0,0,0,s,b
b,0,0,0,b,k,b,b,b,b,b,b,b,b,b,b
b,0,0,0,b,0,0,0,0,0,0,0,0,0,0,b
b,0,0,0,b,g,b,b,b,b,b,b,b,0,0,b
b,0,0,0,b,b,b,b,b,b,b,b,b,0,0,b
b,0,0,0,0,0,0,0,0,0,0,0,0,0,0,b
b,b,b,b,0,0,0,0,0,0,0,0,0,0,0,b
b,b,b,b,b,b,b,b,b,b,b,b,b,b,b,b